111111111111111111111
1E0000000000011000001
111100000100011000001
1000P1000100000001001
111100000100011000001
100001010100011000001
110001000000011000001
111100000101011000001
111111111111111111111