111111111111111111111
1ECC100C0000011000C01
11110000010C01100C001
1C00P10001000CC0010C1
111100C0010C01100C001
10000101010C011C00001
11000100000C011000001
1111000C010101100C001
111111111111111111111